0, 0, 0, 0, 0, 0, 0, 0, 0, 0, 0, 0, 0, 0,
0, 0, 13, 12, 12, 12, 12, 12, 12, 12, 12, 11, 0, 0,
0, 15, 0, 0, 0, 0, 0, 0, 0, 0, 0, 0, 9, 0,
0, 16, 0, 0, 37, 0, 37, 0, 37, 0, 0, 0, 8, 0,
0, 17, 1, 0, 0, 0, 0, 0, 0, 0, 0, 35, 7, 0,
0, 0, 3, 4, 4, 4, 4, 4, 4, 4, 4, 5, 0, 0,
0, 0, 0, 0, 0, 0, 0, 0, 0, 0, 0, 0, 0, 0,
0, 0, 0, 0, 0, 0, 0, 0, 0, 0, 0, 0, 0, 0