0, 0, 0, 0, 0, 0, 12, 12, 0, 0, 0, 0, 0, 0,
0, 0, 0, 0, 0, 16, 36, 36, 8, 0, 0, 0, 0, 0,
0, 0, 0, 13, 12, 14, 34, 34, 10, 12, 12, 0, 0, 0,
0, 0, 14, 0, 0, 0, 0, 0, 19, 0, 0, 9, 0, 0,
0, 15, 0, 0, 37, 0, 0, 0, 34, 24, 35, 7, 0, 0,
0, 17, 1, 0, 24, 0, 6, 3, 4, 4, 5, 0, 0, 0,
0, 0, 4, 4, 4, 5, 0, 0, 0, 0, 0, 0, 0, 0,
0, 0, 0, 0, 0, 0, 0, 0, 0, 0, 0, 0, 0, 0