0, 0, 0, 0, 14, 1, 0, 10, 0, 0, 0, 0, 0, 0,
0, 0, 0, 14, 0, 0, 0, 0, 10, 0, 0, 0, 0, 0,
0, 0, 15, 0, 0, 0, 0, 36, 0, 10, 12, 13, 0, 0,
0, 0, 16, 0, 0, 0, 0, 19, 0, 0, 0, 0, 9, 0,
0, 0, 17, 0, 0, 34, 34, 0, 0, 0, 30, 35, 8, 0,
0, 0, 0, 2, 24, 24, 24, 28, 28, 6, 18, 18, 0, 0,
0, 0, 0, 0, 3, 4, 4, 4, 5, 0, 0, 0, 0, 0,
0, 0, 0, 0, 0, 0, 0, 0, 0, 0, 0, 0, 0, 0