0, 0, 0, 0, 0, 0, 0, 0, 0, 0, 0, 0, 0, 0,
0, 0, 0, 13, 12, 12, 12, 12, 12, 12, 12, 11, 0, 0,
0, 0, 14, 0, 0, 0, 0, 0, 37, 34, 36, 35, 8, 0,
0, 15, 0, 0, 0, 0, 0, 6, 3, 4, 20, 5, 0, 0,
0, 16, 0, 0, 0, 0, 0, 8, 0, 0, 0, 0, 0, 0,
0, 17, 1, 0, 28, 24, 28, 8, 0, 0, 0, 0, 0, 0,
0, 0, 3, 4, 4, 4, 5, 0, 0, 0, 0, 0, 0, 0,
0, 0, 0, 0, 0, 0, 0, 0, 0, 0, 0, 0, 0, 0