0, 0, 0, 0, 0, 0, 0, 0, 0, 0, 0, 0, 0, 0,
0, 0, 0, 0, 0, 0, 0, 0, 0, 0, 0, 0, 0, 0,
0, 0, 0, 13, 12, 12, 12, 12, 12, 12, 11, 0, 0, 0,
0, 0, 16, 1, 0, 24, 0, 34, 0, 0, 35, 8, 0, 0,
0, 0, 0, 3, 4, 4, 4, 4, 4, 4, 5, 0, 0, 0,
0, 0, 0, 0, 0, 0, 0, 0, 0, 0, 0, 0, 0, 0,
0, 0, 0, 0, 0, 0, 0, 0, 0, 0, 0, 0, 0, 0,
0, 0, 0, 0, 0, 0, 0, 0, 0, 0, 0, 0, 0, 0