0, 0, 0, 0, 0, 0, 0, 0, 0, 0, 0, 0, 0, 0,
0, 0, 0, 0, 0, 13, 12, 12, 12, 12, 11, 0, 0, 0,
0, 0, 13, 12, 14, 0, 0, 0, 0, 0, 34, 8, 0, 0,
0, 15, 19, 0, 0, 0, 0, 36, 0, 0, 35, 8, 0, 0,
0, 16, 0, 0, 0, 0, 0, 6, 3, 4, 18, 0, 0, 0,
0, 17, 1, 0, 28, 0, 0, 8, 0, 0, 0, 0, 0, 0,
0, 0, 3, 4, 4, 4, 5, 0, 0, 0, 0, 0, 0, 0,
0, 0, 0, 0, 0, 0, 0, 0, 0, 0, 0, 0, 0, 0