0, 0, 16, 1, 8, 0, 0, 0, 0, 0, 0, 0, 0, 0,
0, 0, 14, 0, 10, 0, 0, 0, 0, 0, 0, 0, 0, 0,
0, 15, 37, 0, 0, 10, 12, 12, 11, 0, 0, 0, 0, 0,
0, 17, 0, 0, 0, 0, 0, 0, 0, 10, 12, 0, 0, 0,
0, 0, 3, 4, 4, 4, 3, 0, 36, 0, 35, 8, 0, 0,
0, 0, 0, 0, 0, 0, 0, 3, 4, 4, 5, 0, 0, 0,
0, 0, 0, 0, 0, 0, 0, 0, 0, 0, 0, 0, 0, 0,
0, 0, 0, 0, 0, 0, 0, 0, 0, 0, 0, 0, 0, 0